round,n_client_req,n_new_updates,n_ontime_updates,n_delayed_updates,n_malicious_updates,n_benign_updates,client_avg_loss_avg,client_train_acc_avg,client_test_acc_avg,benign_client_train_acc_avg,benign_client_test_acc_avg,malicious_client_train_acc_avg,malicious_client_test_acc_avg,accuracy_score,aggregator_time
0,100,36,36,0,0,36,0.691129207611084,0.4768518805503845,0.46335697174072266,0.4768518805503845,0.4768518805503845,0,0,0.46335697399527187,19.666181087493896
1,93,58,52,6,0,58,0.689776599407196,0.47126439213752747,0.46335700154304504,0.47126439213752747,0.47126439213752747,0,0,0.46335697399527187,16.809865474700928
2,91,32,29,3,0,32,0.6899310946464539,0.4583333134651184,0.46335697174072266,0.4583333134651184,0.4583333134651184,0,0,0.46335697399527187,17.774246215820312
3,86,23,20,3,0,23,0.6859869360923767,0.48550722002983093,0.46335697174072266,0.48550722002983093,0.48550722002983093,0,0,0.46335697399527187,16.145896434783936
4,84,54,43,11,0,54,0.6857438087463379,0.4830247163772583,0.46335697174072266,0.4830247163772583,0.4830247163772583,0,0,0.46335697399527187,18.96036410331726
5,68,32,25,7,0,32,0.6842571496963501,0.4999999701976776,0.46335697174072266,0.4999999701976776,0.4999999701976776,0,0,0.46335697399527187,13.701215028762817
6,69,29,14,15,0,29,0.6855797171592712,0.47701144218444824,0.46335697174072266,0.47701144218444824,0.47701144218444824,0,0,0.46335697399527187,16.284961462020874
7,65,10,2,8,0,10,0.6860781908035278,0.4833333492279053,0.46335697174072266,0.4833333492279053,0.4833333492279053,0,0,0.46335697399527187,14.578058242797852
8,63,30,13,17,0,30,0.6893489956855774,0.4333333373069763,0.46335697174072266,0.4333333373069763,0.4333333373069763,0,0,0.46335697399527187,16.56997299194336
9,56,17,1,16,0,17,0.6861608624458313,0.48039212822914124,0.46335697174072266,0.48039212822914124,0.48039212822914124,0,0,0.46335697399527187,16.2955904006958
10,46,17,0,17,0,17,0.6896969079971313,0.44607844948768616,0.46335697174072266,0.44607844948768616,0.44607844948768616,0,0,0.46335697399527187,17.058043956756592
11,48,24,5,19,0,24,0.685307502746582,0.4687499701976776,0.46335697174072266,0.4687499701976776,0.4687499701976776,0,0,0.46335697399527187,18.667317867279053
12,47,25,0,25,0,25,0.684968113899231,0.49666664004325867,0.46335697174072266,0.49666664004325867,0.49666664004325867,0,0,0.46335697399527187,15.228761196136475
13,47,19,0,19,0,19,0.6884738206863403,0.44736841320991516,0.46335697174072266,0.44736841320991516,0.44736841320991516,0,0,0.46335697399527187,16.102757930755615
14,41,39,16,23,0,39,0.6821016669273376,0.5106837153434753,0.46335700154304504,0.5106837153434753,0.5106837153434753,0,0,0.46335697399527187,15.737846374511719
15,42,49,21,28,0,49,0.6846052408218384,0.4812925159931183,0.46335694193840027,0.4812925159931183,0.4812925159931183,0,0,0.46335697399527187,16.888623237609863
16,48,49,24,25,0,49,0.6851130723953247,0.47278910875320435,0.46335694193840027,0.47278910875320435,0.47278910875320435,0,0,0.46335697399527187,15.408551931381226
17,39,34,0,34,0,34,0.6874799132347107,0.448529452085495,0.46335697174072266,0.448529452085495,0.448529452085495,0,0,0.46335697399527187,17.23188042640686
18,46,40,13,27,0,40,0.6861866116523743,0.4562499523162842,0.46335697174072266,0.4562499523162842,0.4562499523162842,0,0,0.46335697399527187,16.864596366882324
19,43,37,0,37,0,37,0.6859623789787292,0.4752252399921417,0.46335694193840027,0.4752252399921417,0.4752252399921417,0,0,0.46335697399527187,18.612168312072754
20,47,40,0,40,0,40,0.6872226595878601,0.46041664481163025,0.46335697174072266,0.46041664481163025,0.46041664481163025,0,0,0.46335697399527187,17.551453113555908
21,42,32,0,32,0,32,0.6880620121955872,0.4296875298023224,0.46335697174072266,0.4296875298023224,0.4296875298023224,0,0,0.46335697399527187,19.59824252128601
22,37,24,0,24,0,24,0.6886436343193054,0.434027761220932,0.46335697174072266,0.434027761220932,0.434027761220932,0,0,0.46335697399527187,18.442733764648438
23,52,71,32,39,0,71,0.6851831078529358,0.4671361744403839,0.46335697174072266,0.4671361744403839,0.4671361744403839,0,0,0.46335697399527187,15.768366813659668
24,34,32,0,32,0,32,0.6866474151611328,0.4635416269302368,0.46335697174072266,0.4635416269302368,0.4635416269302368,0,0,0.46335697399527187,17.804358959197998
25,47,48,0,48,0,48,0.684593141078949,0.4878472089767456,0.46335697174072266,0.4878472089767456,0.4878472089767456,0,0,0.46335697399527187,16.216092109680176
26,43,59,23,36,0,59,0.684836745262146,0.4675140976905823,0.46335700154304504,0.4675140976905823,0.4675140976905823,0,0,0.46335697399527187,18.321063995361328
27,56,39,0,39,0,39,0.6856524348258972,0.46581193804740906,0.46335700154304504,0.46581193804740906,0.46581193804740906,0,0,0.46335697399527187,16.196024179458618
28,41,40,0,40,0,40,0.6833341717720032,0.4937500059604645,0.46335697174072266,0.4937500059604645,0.4937500059604645,0,0,0.46335697399527187,18.33882999420166
29,45,48,11,37,0,48,0.6833481788635254,0.496527761220932,0.46335697174072266,0.496527761220932,0.496527761220932,0,0,0.46335697399527187,16.10226845741272
30,46,49,18,31,0,49,0.6837950944900513,0.4744897484779358,0.46335694193840027,0.4744897484779358,0.4744897484779358,0,0,0.46335697399527187,18.04100203514099
31,37,40,0,40,0,40,0.6830772161483765,0.4895833432674408,0.46335697174072266,0.4895833432674408,0.4895833432674408,0,0,0.46335697399527187,15.60728406906128
32,50,44,2,42,0,44,0.6833904385566711,0.4962121248245239,0.46335697174072266,0.4962121248245239,0.4962121248245239,0,0,0.46335697399527187,17.320032358169556
33,45,32,0,32,0,32,0.6807388067245483,0.5182291865348816,0.46335697174072266,0.5182291865348816,0.5182291865348816,0,0,0.46335697399527187,17.68448495864868
34,40,49,0,49,0,49,0.6858024597167969,0.4404762089252472,0.46335694193840027,0.4404762089252472,0.4404762089252472,0,0,0.46335697399527187,18.64583730697632
35,45,37,0,37,0,37,0.6862976551055908,0.43918919563293457,0.46335694193840027,0.43918919563293457,0.43918919563293457,0,0,0.46335697399527187,17.808239221572876
36,43,48,3,45,0,48,0.6843177676200867,0.472222238779068,0.46335697174072266,0.472222238779068,0.472222238779068,0,0,0.46335697399527187,17.923689126968384
37,38,57,0,57,0,57,0.6839008927345276,0.4795322120189667,0.46335703134536743,0.4795322120189667,0.4795322120189667,0,0,0.46335697399527187,18.538421392440796
38,49,51,0,51,0,51,0.685190737247467,0.4493464231491089,0.46335700154304504,0.4493464231491089,0.4493464231491089,0,0,0.46335697399527187,15.688546419143677
39,35,26,0,26,0,26,0.6836057305335999,0.4583333432674408,0.46335697174072266,0.4583333432674408,0.4583333432674408,0,0,0.46335697399527187,15.976814031600952
40,47,54,21,33,0,54,0.6834841370582581,0.4660494029521942,0.46335697174072266,0.4660494029521942,0.4660494029521942,0,0,0.46335697399527187,14.495684623718262
41,44,33,0,33,0,33,0.6838947534561157,0.469696968793869,0.46335697174072266,0.469696968793869,0.469696968793869,0,0,0.46335697399527187,15.658751487731934
42,39,42,0,42,0,42,0.6811032295227051,0.5019841194152832,0.4633569121360779,0.5019841194152832,0.5019841194152832,0,0,0.46335697399527187,14.268471717834473
43,46,32,0,32,0,32,0.6841774582862854,0.4713541865348816,0.46335697174072266,0.4713541865348816,0.4713541865348816,0,0,0.46335697399527187,14.17884349822998
44,37,35,0,35,0,35,0.6871041059494019,0.4119047522544861,0.46335700154304504,0.4119047522544861,0.4119047522544861,0,0,0.46335697399527187,16.91164207458496
45,41,30,0,30,0,30,0.6790676116943359,0.5138888955116272,0.46335697174072266,0.5138888955116272,0.5138888955116272,0,0,0.46335697399527187,15.40317177772522
46,40,37,0,37,0,37,0.6846728324890137,0.44144144654273987,0.46335694193840027,0.44144144654273987,0.44144144654273987,0,0,0.46335697399527187,15.480310916900635
47,38,33,0,33,0,33,0.6829862594604492,0.47727271914482117,0.46335697174072266,0.47727271914482117,0.47727271914482117,0,0,0.46335697399527187,15.671120405197144
48,36,39,0,39,0,39,0.6831222772598267,0.4636751711368561,0.46335700154304504,0.4636751711368561,0.4636751711368561,0,0,0.46335697399527187,13.733959436416626
49,40,25,0,25,0,25,0.6828129291534424,0.4766666889190674,0.46335697174072266,0.4766666889190674,0.4766666889190674,0,0,0.46335697399527187,12.822154760360718
50,42,49,12,37,0,49,0.6823834776878357,0.47278910875320435,0.46335694193840027,0.47278910875320435,0.47278910875320435,0,0,0.46335697399527187,18.788326025009155
51,34,51,3,48,0,51,0.6814389824867249,0.4771241843700409,0.46335700154304504,0.4771241843700409,0.4771241843700409,0,0,0.46335697399527187,16.06976842880249
52,48,40,0,40,0,40,0.6828228235244751,0.4624999463558197,0.46335697174072266,0.4624999463558197,0.4624999463558197,0,0,0.46335697399527187,15.52163028717041
53,25,53,0,53,0,53,0.6851441860198975,0.42924532294273376,0.46335700154304504,0.42924532294273376,0.42924532294273376,0,0,0.46335697399527187,12.796637535095215
54,40,55,13,42,0,55,0.6830893754959106,0.459090918302536,0.46335694193840027,0.459090918302536,0.459090918302536,0,0,0.46335697399527187,15.685177564620972
55,37,38,0,38,0,38,0.6856207847595215,0.42543864250183105,0.46335697174072266,0.42543864250183105,0.42543864250183105,0,0,0.46335697399527187,12.98578429222107
56,45,42,9,33,0,42,0.6833463311195374,0.4503968060016632,0.4633569121360779,0.4503968060016632,0.4503968060016632,0,0,0.46335697399527187,16.238739252090454
57,47,42,0,42,0,42,0.6834284067153931,0.4583333432674408,0.4633569121360779,0.4583333432674408,0.4583333432674408,0,0,0.46335697399527187,12.954801559448242
58,45,62,25,37,0,62,0.682876706123352,0.4543010890483856,0.46335700154304504,0.4543010890483856,0.4543010890483856,0,0,0.46335697399527187,14.119214534759521
59,45,48,24,24,0,48,0.6787903904914856,0.4895833432674408,0.46335697174072266,0.4895833432674408,0.4895833432674408,0,0,0.46335697399527187,12.882833003997803
60,40,41,1,40,0,41,0.6837863326072693,0.4491869807243347,0.46335694193840027,0.4491869807243347,0.4491869807243347,0,0,0.46335697399527187,17.50688648223877
61,44,62,15,47,0,62,0.6791727542877197,0.49462369084358215,0.46335700154304504,0.49462369084358215,0.49462369084358215,0,0,0.46335697399527187,16.01116943359375
62,39,42,7,35,0,42,0.681728720664978,0.4682539403438568,0.4633569121360779,0.4682539403438568,0.4682539403438568,0,0,0.46335697399527187,14.371384859085083
63,44,42,0,42,0,42,0.6806715726852417,0.4801587462425232,0.4633569121360779,0.4801587462425232,0.4801587462425232,0,0,0.46335697399527187,16.034959316253662
64,48,49,14,35,0,49,0.6817613840103149,0.45578232407569885,0.46335694193840027,0.45578232407569885,0.45578232407569885,0,0,0.46335697399527187,15.885048389434814
65,49,61,20,41,0,61,0.6808586716651917,0.4658470153808594,0.46335703134536743,0.4658470153808594,0.4658470153808594,0,0,0.46335697399527187,15.504744529724121
66,47,54,19,35,0,54,0.6797187924385071,0.4753086268901825,0.46335697174072266,0.4753086268901825,0.4753086268901825,0,0,0.46335697399527187,16.465235233306885
67,47,35,0,35,0,35,0.6827272772789001,0.4523809552192688,0.46335700154304504,0.4523809552192688,0.4523809552192688,0,0,0.46335697399527187,17.09349489212036
68,58,32,4,28,0,32,0.6816909909248352,0.453125,0.46335697174072266,0.453125,0.453125,0,0,0.46335697399527187,14.686023235321045
69,40,64,19,45,0,64,0.6824690699577332,0.4361979365348816,0.46335697174072266,0.4361979365348816,0.4361979365348816,0,0,0.46335697399527187,15.132038354873657
70,52,60,15,45,0,60,0.6807774305343628,0.4652777910232544,0.46335703134536743,0.4652777910232544,0.4652777910232544,0,0,0.46335697399527187,15.82416558265686
71,45,34,0,34,0,34,0.6801056265830994,0.46813729405403137,0.46335697174072266,0.46813729405403137,0.46813729405403137,0,0,0.46335697399527187,15.14271855354309
72,46,33,0,33,0,33,0.6776863932609558,0.497474730014801,0.46335697174072266,0.497474730014801,0.497474730014801,0,0,0.46335697399527187,15.436398267745972
73,47,43,10,33,0,43,0.6794525980949402,0.47093021869659424,0.46335700154304504,0.47093021869659424,0.47093021869659424,0,0,0.46335697399527187,17.1289541721344
74,53,46,12,34,0,46,0.6781284213066101,0.48188403248786926,0.46335694193840027,0.48188403248786926,0.48188403248786926,0,0,0.46335697399527187,22.590641736984253
75,47,39,0,39,0,39,0.6822914481163025,0.43589749932289124,0.46335700154304504,0.43589749932289124,0.43589749932289124,0,0,0.46335697399527187,21.66091752052307
76,40,41,0,41,0,41,0.6780718564987183,0.4939024746417999,0.46335694193840027,0.4939024746417999,0.4939024746417999,0,0,0.46335697399527187,21.015974760055542
77,43,38,7,31,0,38,0.6732451915740967,0.550438642501831,0.46335697174072266,0.550438642501831,0.550438642501831,0,0,0.46335697399527187,20.383203268051147
78,36,35,0,35,0,35,0.6798548102378845,0.46666663885116577,0.46335700154304504,0.46666663885116577,0.46666663885116577,0,0,0.46335697399527187,17.889145135879517
79,44,38,0,38,0,38,0.6796366572380066,0.4583333134651184,0.46335697174072266,0.4583333134651184,0.4583333134651184,0,0,0.46335697399527187,18.516903162002563
80,57,43,0,43,0,43,0.6774150133132935,0.4961239993572235,0.46335700154304504,0.4961239993572235,0.4961239993572235,0,0,0.46335697399527187,21.978537797927856
81,46,49,14,35,0,49,0.6795918941497803,0.4591836631298065,0.46335694193840027,0.4591836631298065,0.4591836631298065,0,0,0.46335697399527187,21.828226327896118
82,41,38,0,38,0,38,0.6760023236274719,0.4978070557117462,0.46335697174072266,0.4978070557117462,0.4978070557117462,0,0,0.46335697399527187,21.980679035186768
83,43,74,23,51,0,74,0.6768375635147095,0.4932432472705841,0.46335694193840027,0.4932432472705841,0.4932432472705841,0,0,0.46335697399527187,23.621280670166016
84,45,42,11,31,0,42,0.6801236271858215,0.4424603283405304,0.4633569121360779,0.4424603283405304,0.4424603283405304,0,0,0.46335697399527187,17.506983041763306
85,38,28,0,28,0,28,0.6765108108520508,0.50297611951828,0.46335697174072266,0.50297611951828,0.50297611951828,0,0,0.46335697399527187,24.10828399658203
86,46,38,0,38,0,38,0.6793136596679688,0.4583333134651184,0.46335697174072266,0.4583333134651184,0.4583333134651184,0,0,0.46335697399527187,23.67996597290039
87,49,31,0,31,0,31,0.6797672510147095,0.4516129195690155,0.46335697174072266,0.4516129195690155,0.4516129195690155,0,0,0.46335697399527187,23.673176050186157
88,40,42,9,33,0,42,0.6761022210121155,0.4920634627342224,0.4633569121360779,0.4920634627342224,0.4920634627342224,0,0,0.46335697399527187,19.5916428565979
89,48,43,0,43,0,43,0.6770438551902771,0.48255813121795654,0.46335700154304504,0.48255813121795654,0.48255813121795654,0,0,0.46335697399527187,25.804075956344604
90,47,49,8,41,0,49,0.6802694201469421,0.4404762089252472,0.46335694193840027,0.4404762089252472,0.4404762089252472,0,0,0.46335697399527187,25.155232429504395
91,40,32,0,32,0,32,0.6754252314567566,0.4921875,0.46335697174072266,0.4921875,0.4921875,0,0,0.46335697399527187,27.637426376342773
92,37,42,0,42,0,42,0.6782776117324829,0.4662698209285736,0.4633569121360779,0.4662698209285736,0.4662698209285736,0,0,0.46335697399527187,26.174321174621582
93,44,46,13,33,0,46,0.6765490174293518,0.4692029058933258,0.46335694193840027,0.4692029058933258,0.4692029058933258,0,0,0.46335697399527187,28.023507833480835
94,43,35,0,35,0,35,0.6801573038101196,0.44285714626312256,0.46335700154304504,0.44285714626312256,0.44285714626312256,0,0,0.46335697399527187,22.82257056236267
95,45,50,0,50,0,50,0.676584780216217,0.4816666841506958,0.46335697174072266,0.4816666841506958,0.4816666841506958,0,0,0.46335697399527187,30.56779146194458
96,43,42,0,42,0,42,0.6802411079406738,0.442460298538208,0.4633569121360779,0.442460298538208,0.442460298538208,0,0,0.46335697399527187,21.437535762786865
97,40,36,0,36,0,36,0.6777815222740173,0.4722221791744232,0.46335697174072266,0.4722221791744232,0.4722221791744232,0,0,0.46335697399527187,24.89965057373047
98,38,46,0,46,0,46,0.6769871711730957,0.4800724685192108,0.46335694193840027,0.4800724685192108,0.4800724685192108,0,0,0.46335697399527187,27.568362951278687
99,40,49,0,49,0,49,0.6756108999252319,0.4795917868614197,0.46335694193840027,0.4795917868614197,0.4795917868614197,0,0,0.46335697399527187,28.99766492843628
