round,n_client_req,n_new_updates,n_ontime_updates,n_delayed_updates,n_malicious_updates,n_benign_updates,client_avg_loss_avg,client_train_acc_avg,client_test_acc_avg,benign_client_train_acc_avg,benign_client_test_acc_avg,malicious_client_train_acc_avg,malicious_client_test_acc_avg,accuracy_score,aggregator_time
0,100,36,36,0,0,36,0.6899540424346924,0.4768518805503845,0.46335697174072266,0.4768518805503845,0.4768518805503845,0,0,0.46335697399527187,0.07819700241088867
1,93,71,65,6,0,71,0.685848593711853,0.48591548204421997,0.46335697174072266,0.48591548204421997,0.48591548204421997,0,0,0.46335697399527187,0.15942072868347168
2,93,56,53,3,0,56,0.6841086149215698,0.4732142984867096,0.46335703134536743,0.4732142984867096,0.4732142984867096,0,0,0.46335697399527187,0.10375523567199707
3,97,57,54,3,0,57,0.6815004944801331,0.46929824352264404,0.46335703134536743,0.46929824352264404,0.46929824352264404,0,0,0.46335697399527187,0.09605050086975098
4,84,52,46,6,0,52,0.6807372570037842,0.4503205120563507,0.46335697174072266,0.4503205120563507,0.4503205120563507,0,0,0.46335697399527187,0.11245298385620117
5,81,25,15,10,0,25,0.6769958734512329,0.49000003933906555,0.46335697174072266,0.49000003933906555,0.49000003933906555,0,0,0.46335697399527187,0.07109737396240234
6,74,52,44,8,0,52,0.6755266785621643,0.45673078298568726,0.46335697174072266,0.45673078298568726,0.45673078298568726,0,0,0.46335697399527187,0.10889601707458496
7,73,64,52,12,0,64,0.6720004081726074,0.4661458134651184,0.46353426575660706,0.4661458134651184,0.4661458134651184,0,0,0.46335697399527187,0.14005541801452637
8,70,46,34,12,0,46,0.671288013458252,0.4655797481536865,0.4643745422363281,0.4655797481536865,0.4655797481536865,0,0,0.46382978723404256,0.11439371109008789
9,67,21,15,6,0,21,0.6666429042816162,0.5198412537574768,0.46736466884613037,0.5198412537574768,0.5198412537574768,0,0,0.4657210401891253,0.0626678466796875
10,64,29,13,16,0,29,0.6755848526954651,0.4511494040489197,0.47183504700660706,0.4511494040489197,0.4511494040489197,0,0,0.4690307328605201,0.14252185821533203
11,57,11,0,11,0,11,0.6751057505607605,0.4393939971923828,0.46868687868118286,0.4393939971923828,0.4393939971923828,0,0,0.466193853427896,0.06966662406921387
12,54,47,31,16,0,47,0.6671526432037354,0.48049646615982056,0.47633418440818787,0.48049646615982056,0.48049646615982056,0,0,0.4723404255319149,0.11680245399475098
13,56,41,22,19,0,41,0.6677398085594177,0.48780491948127747,0.4868823289871216,0.48780491948127747,0.48780491948127747,0,0,0.4874704491725768,0.19698786735534668
14,54,22,0,22,0,22,0.6730707287788391,0.5037878155708313,0.47390928864479065,0.5037878155708313,0.5037878155708313,0,0,0.4685579196217494,0.16304850578308105
15,48,48,23,25,0,48,0.6658200025558472,0.5121528506278992,0.4835401773452759,0.5121528506278992,0.5121528506278992,0,0,0.48274231678486995,0.14552092552185059
16,44,25,3,22,0,25,0.6707668900489807,0.47999998927116394,0.4790165424346924,0.47999998927116394,0.47999998927116394,0,0,0.48274231678486995,0.16731595993041992
17,42,29,15,14,0,29,0.6676160097122192,0.49425286054611206,0.5014755129814148,0.49425286054611206,0.49425286054611206,0,0,0.5044917257683215,0.09865331649780273
18,46,25,7,18,0,25,0.6665351986885071,0.5333333015441895,0.5050023198127747,0.5333333015441895,0.5333333015441895,0,0,0.5111111111111111,0.13947153091430664
19,58,61,32,29,0,61,0.6600441932678223,0.5546448230743408,0.5291555523872375,0.5546448230743408,0.5546448230743408,0,0,0.5399527186761229,0.21341443061828613
20,46,43,16,27,0,43,0.6646437644958496,0.5406976938247681,0.5338171720504761,0.5406976938247681,0.5406976938247681,0,0,0.5640661938534279,0.23599934577941895
21,39,22,0,22,0,22,0.6658731698989868,0.5492424368858337,0.4936385154724121,0.5492424368858337,0.5492424368858337,0,0,0.4955082742316785,0.1501312255859375
22,47,29,0,29,0,29,0.6673921942710876,0.4999999701976776,0.48686718940734863,0.4999999701976776,0.4999999701976776,0,0,0.4955082742316785,0.18734216690063477
23,42,33,0,33,0,33,0.6659002900123596,0.4974747896194458,0.48767101764678955,0.4974747896194458,0.4974747896194458,0,0,0.49361702127659574,0.241685152053833
24,43,45,2,43,0,45,0.6679059267044067,0.5092592239379883,0.4887942969799042,0.5092592239379883,0.5092592239379883,0,0,0.48605200945626476,0.2884070873260498
25,39,36,0,36,0,36,0.6676642894744873,0.5324074625968933,0.5107433795928955,0.5324074625968933,0.5324074625968933,0,0,0.5191489361702127,0.21040558815002441
26,45,36,0,36,0,36,0.6732015013694763,0.4861111044883728,0.5119385719299316,0.4861111044883728,0.4861111044883728,0,0,0.5300236406619385,0.3422839641571045
27,45,36,0,36,0,36,0.6616460680961609,0.5509259104728699,0.5080378651618958,0.5509259104728699,0.5509259104728699,0,0,0.4988179669030733,0.14339828491210938
28,41,49,15,34,0,49,0.6587733030319214,0.5544217824935913,0.521995484828949,0.5544217824935913,0.5544217824935913,0,0,0.5257683215130023,0.17349886894226074
29,45,54,13,41,0,54,0.6606350541114807,0.5370370745658875,0.5349268913269043,0.5370370745658875,0.5370370745658875,0,0,0.5527186761229315,0.19264578819274902
30,38,47,12,35,0,47,0.6554837822914124,0.5975177884101868,0.5480006337165833,0.5975177884101868,0.5975177884101868,0,0,0.5711583924349882,0.14638066291809082
31,35,50,0,50,0,50,0.6619133949279785,0.5149999856948853,0.5155460834503174,0.5149999856948853,0.5149999856948853,0,0,0.5446808510638298,0.2485649585723877
32,41,57,17,40,0,57,0.659456193447113,0.5672515034675598,0.5510016083717346,0.5672515034675598,0.5672515034675598,0,0,0.5825059101654846,0.21306467056274414
33,41,40,0,40,0,40,0.6608079671859741,0.5499999523162842,0.5251891016960144,0.5499999523162842,0.5499999523162842,0,0,0.5560283687943263,0.3024435043334961
34,38,52,18,34,0,52,0.6545045375823975,0.5769230723381042,0.5597108602523804,0.5769230723381042,0.5769230723381042,0,0,0.5914893617021276,0.15198588371276855
35,50,36,0,36,0,36,0.6634773015975952,0.5277777910232544,0.5575781464576721,0.5277777910232544,0.5277777910232544,0,0,0.6047281323877068,0.141340970993042
36,53,33,0,33,0,33,0.6580476760864258,0.5707070231437683,0.5574038624763489,0.5707070231437683,0.5707070231437683,0,0,0.6174940898345154,0.13176226615905762
37,46,63,19,44,0,63,0.6524456739425659,0.6164021492004395,0.5942736864089966,0.6164021492004395,0.6164021492004395,0,0,0.6382978723404256,0.21411561965942383
38,53,41,0,41,0,41,0.6515486240386963,0.5975610017776489,0.558057963848114,0.5975610017776489,0.5975610017776489,0,0,0.601418439716312,0.2512197494506836
39,51,67,30,37,0,67,0.6547280550003052,0.6169154047966003,0.6131752729415894,0.6169154047966003,0.6169154047966003,0,0,0.6416075650118204,0.1993117332458496
40,48,31,0,31,0,31,0.6505231261253357,0.6129031777381897,0.5580722093582153,0.6129031777381897,0.6129031777381897,0,0,0.6122931442080378,0.12456750869750977
41,53,37,3,34,0,37,0.6533365249633789,0.6441441178321838,0.6204587817192078,0.6441441178321838,0.6441441178321838,0,0,0.6539007092198581,0.11839938163757324
42,39,65,18,47,0,65,0.6520451903343201,0.6435897350311279,0.6336424350738525,0.6435897350311279,0.6435897350311279,0,0,0.6789598108747045,0.1928420066833496
43,44,54,13,41,0,54,0.6530483365058899,0.6296296119689941,0.637825071811676,0.6296296119689941,0.6296296119689941,0,0,0.6936170212765957,0.2442941665649414
44,45,40,0,40,0,40,0.6519706845283508,0.6520832777023315,0.6371749639511108,0.6520832777023315,0.6520832777023315,0,0,0.6789598108747045,0.16639399528503418
45,47,31,0,31,0,31,0.6535318493843079,0.6424731016159058,0.6408754587173462,0.6424731016159058,0.6424731016159058,0,0,0.6832151300236406,0.11136150360107422
46,37,42,0,42,0,42,0.6507772207260132,0.64682537317276,0.6284701228141785,0.64682537317276,0.64682537317276,0,0,0.667612293144208,0.33568716049194336
47,55,57,13,44,0,57,0.6539373397827148,0.6447368264198303,0.6531126499176025,0.6447368264198303,0.6447368264198303,0,0,0.706855791962175,0.2738938331604004
48,58,42,2,40,0,42,0.6485056281089783,0.6488094925880432,0.6424744129180908,0.6488094925880432,0.6488094925880432,0,0,0.6898345153664303,0.2085251808166504
49,42,41,0,41,0,41,0.6488582491874695,0.6544715166091919,0.6497952342033386,0.6544715166091919,0.6544715166091919,0,0,0.7106382978723405,0.16585898399353027
50,48,37,0,37,0,37,0.6480357050895691,0.6914414763450623,0.6403935551643372,0.6914414763450623,0.6914414763450623,0,0,0.6931442080378251,0.16594672203063965
51,44,49,17,32,0,49,0.6475885510444641,0.7125849723815918,0.6862064003944397,0.7125849723815918,0.7125849723815918,0,0,0.7328605200945626,0.15978789329528809
52,44,57,9,48,0,57,0.6443904638290405,0.7251462340354919,0.6635311841964722,0.7251462340354919,0.7251462340354919,0,0,0.7276595744680852,0.35918188095092773
53,43,42,0,42,0,42,0.650398850440979,0.6884921193122864,0.6770572662353516,0.6884921193122864,0.6884921193122864,0,0,0.7314420803782505,0.18858981132507324
54,52,58,17,41,0,58,0.6449812650680542,0.6982758641242981,0.7020950317382812,0.6982758641242981,0.6982758641242981,0,0,0.7465721040189125,0.39745092391967773
55,47,54,16,38,0,54,0.6451980471611023,0.7376542687416077,0.7283951044082642,0.7376542687416077,0.7376542687416077,0,0,0.7621749408983451,0.19062185287475586
56,48,38,0,38,0,38,0.6443765759468079,0.7280701994895935,0.7028617858886719,0.7280701994895935,0.7280701994895935,0,0,0.7404255319148936,0.1565232276916504
57,44,62,18,44,0,62,0.6424936652183533,0.75,0.725516676902771,0.75,0.75,0,0,0.7602836879432624,0.22114300727844238
58,37,33,0,33,0,33,0.6480690836906433,0.7272728085517883,0.7252525091171265,0.7272728085517883,0.7272728085517883,0,0,0.7555555555555555,0.14707207679748535
59,49,65,23,42,0,65,0.6409103870391846,0.7602564096450806,0.745997428894043,0.7602564096450806,0.7602564096450806,0,0,0.7773049645390071,0.22764253616333008
60,56,36,8,28,0,36,0.6376542448997498,0.7777778506278992,0.7337799072265625,0.7777778506278992,0.7777778506278992,0,0,0.7773049645390071,0.1796576976776123
61,42,45,2,43,0,45,0.6423893570899963,0.7462962865829468,0.7293617129325867,0.7462962865829468,0.7462962865829468,0,0,0.7749408983451537,0.15702056884765625
62,43,35,0,35,0,35,0.6438435912132263,0.771428644657135,0.7341979146003723,0.771428644657135,0.771428644657135,0,0,0.7768321513002364,0.14189648628234863
63,48,41,4,37,0,41,0.6382612586021423,0.7703251838684082,0.7525110840797424,0.7703251838684082,0.7703251838684082,0,0,0.7919621749408984,0.15858888626098633
64,45,55,24,31,0,55,0.6368445754051208,0.8060606122016907,0.7935010194778442,0.8060606122016907,0.8060606122016907,0,0,0.8127659574468085,0.182814359664917
65,48,68,17,51,0,68,0.6365785002708435,0.7855392098426819,0.7676330804824829,0.7855392098426819,0.7855392098426819,0,0,0.8146572104018912,0.328049898147583
66,56,63,28,35,0,63,0.6367049217224121,0.8095238208770752,0.7962775826454163,0.8095238208770752,0.8095238208770752,0,0,0.8349881796690307,0.2157435417175293
67,47,55,19,36,0,55,0.6367377042770386,0.7863636612892151,0.7903460264205933,0.7863636612892151,0.7863636612892151,0,0,0.8397163120567376,0.28153204917907715
68,53,51,16,35,0,51,0.6364116072654724,0.8202614188194275,0.8031243085861206,0.8202614188194275,0.8202614188194275,0,0,0.849645390070922,0.24501609802246094
69,45,38,14,24,0,38,0.6404632329940796,0.7982456088066101,0.7987059354782104,0.7982456088066101,0.7982456088066101,0,0,0.8619385342789598,0.28767919540405273
70,54,43,0,43,0,43,0.6375375986099243,0.7906976938247681,0.769805908203125,0.7906976938247681,0.7906976938247681,0,0,0.807565011820331,0.22845697402954102
71,50,58,17,41,0,58,0.6371885538101196,0.8103447556495667,0.8012309074401855,0.8103447556495667,0.8103447556495667,0,0,0.8264775413711584,0.26418399810791016
72,53,59,28,31,0,59,0.6315895915031433,0.8672316670417786,0.8446288108825684,0.8672316670417786,0.8672316670417786,0,0,0.8609929078014185,0.1717088222503662
73,47,65,26,39,0,65,0.6314644813537598,0.8346154093742371,0.8282742500305176,0.8346154093742371,0.8346154093742371,0,0,0.8695035460992908,0.27918076515197754
74,50,41,0,41,0,41,0.6361207962036133,0.8048780560493469,0.796136736869812,0.8048780560493469,0.8048780560493469,0,0,0.8316784869976359,0.1842203140258789
75,38,30,0,30,0,30,0.637782096862793,0.7972221970558167,0.7870920896530151,0.7972221970558167,0.7972221970558167,0,0,0.8416075650118203,0.155975341796875
76,45,38,0,38,0,38,0.6393897533416748,0.7850877642631531,0.8090829849243164,0.7850877642631531,0.7850877642631531,0,0,0.8520094562647754,0.17693161964416504
77,39,39,0,39,0,39,0.6370716094970703,0.8183761239051819,0.8185730576515198,0.8183761239051819,0.8183761239051819,0,0,0.8444444444444444,0.17087602615356445
78,48,26,0,26,0,26,0.628368616104126,0.8557692170143127,0.8272594809532166,0.8557692170143127,0.8557692170143127,0,0,0.8515366430260047,0.152116060256958
79,48,49,0,49,0,49,0.630366861820221,0.8571428656578064,0.8247889876365662,0.8571428656578064,0.8571428656578064,0,0,0.8505910165484634,0.21524405479431152
80,48,48,17,31,0,48,0.6236631870269775,0.8802083134651184,0.8452029228210449,0.8802083134651184,0.8802083134651184,0,0,0.8676122931442081,0.14971470832824707
81,46,32,0,32,0,32,0.6343743205070496,0.8463541269302368,0.8309100866317749,0.8463541269302368,0.8463541269302368,0,0,0.8638297872340426,0.2044200897216797
82,37,49,13,36,0,49,0.6310157775878906,0.8656463027000427,0.8533024787902832,0.8656463027000427,0.8656463027000427,0,0,0.8775413711583925,0.21488165855407715
83,41,23,0,23,0,23,0.6337921023368835,0.8369565010070801,0.8414843082427979,0.8369565010070801,0.8369565010070801,0,0,0.8723404255319149,0.13637566566467285
84,46,36,0,36,0,36,0.627232551574707,0.8657407760620117,0.8454557657241821,0.8657407760620117,0.8657407760620117,0,0,0.8713947990543736,0.1774752140045166
85,42,47,7,40,0,47,0.6241289377212524,0.867021381855011,0.8599969744682312,0.867021381855011,0.867021381855011,0,0,0.8775413711583925,0.1856377124786377
86,37,23,0,23,0,23,0.6328846216201782,0.8695651888847351,0.8712509274482727,0.8695651888847351,0.8695651888847351,0,0,0.8879432624113475,0.1230165958404541
87,48,52,11,41,0,52,0.6262577772140503,0.8974358439445496,0.8747863173484802,0.8974358439445496,0.8974358439445496,0,0,0.8959810874704491,0.31797289848327637
88,42,53,0,53,0,53,0.6269871592521667,0.8694968819618225,0.8700209856033325,0.8694968819618225,0.8694968819618225,0,0,0.8874704491725768,0.20456242561340332
89,49,44,0,44,0,44,0.6267115473747253,0.8844696283340454,0.865119218826294,0.8844696283340454,0.8844696283340454,0,0,0.8860520094562647,0.18825864791870117
90,41,36,0,36,0,36,0.6193358898162842,0.891203761100769,0.868899405002594,0.891203761100769,0.891203761100769,0,0,0.8940898345153664,0.13551855087280273
91,34,30,0,30,0,30,0.6204283833503723,0.8777778148651123,0.8854057788848877,0.8777778148651123,0.8777778148651123,0,0,0.8992907801418439,0.09998035430908203
92,33,55,9,46,0,55,0.6228328347206116,0.8727272152900696,0.8844358921051025,0.8727272152900696,0.8727272152900696,0,0,0.9035460992907801,0.33905887603759766
93,48,62,21,41,0,62,0.6237843632698059,0.9086021780967712,0.8933578133583069,0.9086021780967712,0.9086021780967712,0,0,0.9148936170212766,0.2279646396636963
94,45,46,7,39,0,46,0.6287955045700073,0.9021739959716797,0.8941618204116821,0.9021739959716797,0.9021739959716797,0,0,0.9148936170212766,0.2587604522705078
95,49,40,4,36,0,40,0.6217542290687561,0.8916667103767395,0.8932861089706421,0.8916667103767395,0.8916667103767395,0,0,0.9115839243498818,0.184922456741333
96,37,41,0,41,0,41,0.6241662502288818,0.8943089842796326,0.8923599720001221,0.8943089842796326,0.8943089842796326,0,0,0.9163120567375886,0.19968223571777344
97,41,35,0,35,0,35,0.627703070640564,0.9023809432983398,0.8861329555511475,0.9023809432983398,0.9023809432983398,0,0,0.9078014184397163,0.19170570373535156
98,43,37,0,37,0,37,0.6247665286064148,0.8918918967247009,0.8908695578575134,0.8918918967247009,0.8918918967247009,0,0,0.908274231678487,0.21910381317138672
99,48,55,17,38,0,55,0.6155307292938232,0.907575786113739,0.906030535697937,0.907575786113739,0.907575786113739,0,0,0.9177304964539007,0.1927168369293213
