round,n_client_req,n_new_updates,n_ontime_updates,n_delayed_updates,n_malicious_updates,n_benign_updates,client_avg_loss_avg,client_train_acc_avg,client_test_acc_avg,benign_client_train_acc_avg,benign_client_test_acc_avg,malicious_client_train_acc_avg,malicious_client_test_acc_avg,accuracy_score,aggregator_time
0,100,36,36,0,0,36,0.691129207611084,0.4768518805503845,0.46335697174072266,0.4768518805503845,0.4768518805503845,0,0,0.46335697399527187,0.15508341789245605
1,93,71,65,6,0,71,0.6886207461357117,0.48591548204421997,0.46335697174072266,0.48591548204421997,0.48591548204421997,0,0,0.46335697399527187,0.3144235610961914
2,93,56,53,3,0,56,0.6883345246315002,0.4732142984867096,0.46335703134536743,0.4732142984867096,0.4732142984867096,0,0,0.46335697399527187,0.23265433311462402
3,97,57,54,3,0,57,0.6872991323471069,0.46929824352264404,0.46335703134536743,0.46929824352264404,0.46929824352264404,0,0,0.46335697399527187,0.32244181632995605
4,84,52,46,6,0,52,0.6875752806663513,0.4503205120563507,0.46335697174072266,0.4503205120563507,0.4503205120563507,0,0,0.46335697399527187,0.13931941986083984
5,81,25,15,10,0,25,0.6845807433128357,0.49000003933906555,0.46335697174072266,0.49000003933906555,0.49000003933906555,0,0,0.46335697399527187,0.2934291362762451
6,74,52,44,8,0,52,0.6847255229949951,0.45673078298568726,0.46335697174072266,0.45673078298568726,0.45673078298568726,0,0,0.46335697399527187,0.29846882820129395
7,73,64,52,12,0,64,0.6829431056976318,0.4661458134651184,0.46335697174072266,0.4661458134651184,0.4661458134651184,0,0,0.46335697399527187,0.3388235569000244
8,70,46,34,12,0,46,0.6826218366622925,0.4637681245803833,0.46335694193840027,0.4637681245803833,0.4637681245803833,0,0,0.46335697399527187,0.31040358543395996
9,67,21,15,6,0,21,0.6793611645698547,0.5000000596046448,0.46335697174072266,0.5000000596046448,0.5000000596046448,0,0,0.46335697399527187,0.15232443809509277
10,64,29,13,16,0,29,0.6858474016189575,0.43103447556495667,0.46335697174072266,0.43103447556495667,0.43103447556495667,0,0,0.46335697399527187,0.403118371963501
11,57,11,0,11,0,11,0.6858956813812256,0.42424246668815613,0.46335697174072266,0.42424246668815613,0.42424246668815613,0,0,0.46335697399527187,0.1389772891998291
12,54,47,31,16,0,47,0.6807342767715454,0.46099284291267395,0.4633569121360779,0.46099284291267395,0.46099284291267395,0,0,0.46335697399527187,0.3192000389099121
13,56,41,22,19,0,41,0.6812580227851868,0.45121949911117554,0.46335694193840027,0.45121949911117554,0.45121949911117554,0,0,0.46335697399527187,0.4640531539916992
14,54,22,0,22,0,22,0.6832693219184875,0.4772726893424988,0.46335697174072266,0.4772726893424988,0.4772726893424988,0,0,0.46335697399527187,0.3882765769958496
15,48,48,23,25,0,48,0.679798424243927,0.4739583432674408,0.46335697174072266,0.4739583432674408,0.4739583432674408,0,0,0.46335697399527187,0.6069602966308594
16,44,25,3,22,0,25,0.6824547648429871,0.46666663885116577,0.46335697174072266,0.46666663885116577,0.46666663885116577,0,0,0.46335697399527187,0.3647575378417969
17,42,29,15,14,0,29,0.6822996735572815,0.4252873361110687,0.46335697174072266,0.4252873361110687,0.4252873361110687,0,0,0.46335697399527187,0.20479154586791992
18,46,25,7,18,0,25,0.680065393447876,0.4766666293144226,0.46335697174072266,0.4766666293144226,0.4766666293144226,0,0,0.46335697399527187,0.26752710342407227
19,58,61,32,29,0,61,0.6766952872276306,0.4890710413455963,0.46335703134536743,0.4890710413455963,0.4890710413455963,0,0,0.46335697399527187,0.507530689239502
20,46,43,16,27,0,43,0.6791540384292603,0.47480618953704834,0.46335700154304504,0.47480618953704834,0.47480618953704834,0,0,0.46335697399527187,0.561058759689331
21,39,22,0,22,0,22,0.6784810423851013,0.5189394354820251,0.46335697174072266,0.5189394354820251,0.5189394354820251,0,0,0.46335697399527187,0.34955763816833496
22,47,29,0,29,0,29,0.6807931065559387,0.4712643325328827,0.46335697174072266,0.4712643325328827,0.4712643325328827,0,0,0.46335697399527187,0.38335132598876953
23,42,33,0,33,0,33,0.6794178485870361,0.47979792952537537,0.46335697174072266,0.47979792952537537,0.47979792952537537,0,0,0.46335697399527187,0.4453771114349365
24,43,45,2,43,0,45,0.6806144118309021,0.47962963581085205,0.46335694193840027,0.47962963581085205,0.47962963581085205,0,0,0.46335697399527187,0.4913012981414795
25,39,36,0,36,0,36,0.6813225150108337,0.4583333432674408,0.46335697174072266,0.4583333432674408,0.4583333432674408,0,0,0.46335697399527187,0.44353795051574707
26,45,36,0,36,0,36,0.6852476596832275,0.4166666865348816,0.46335697174072266,0.4166666865348816,0.4166666865348816,0,0,0.46335697399527187,0.6309497356414795
27,45,36,0,36,0,36,0.6773583889007568,0.49768516421318054,0.46335697174072266,0.49768516421318054,0.49768516421318054,0,0,0.46335697399527187,0.3303205966949463
28,41,49,15,34,0,49,0.6760666370391846,0.488095223903656,0.46335694193840027,0.488095223903656,0.488095223903656,0,0,0.46335697399527187,0.3171992301940918
29,45,54,13,41,0,54,0.6783061623573303,0.458333283662796,0.46335697174072266,0.458333283662796,0.458333283662796,0,0,0.46335697399527187,0.39735841751098633
30,38,47,12,35,0,47,0.6746503114700317,0.5,0.4633569121360779,0.5,0.5,0,0,0.46335697399527187,0.552276611328125
31,35,50,0,50,0,50,0.6782792806625366,0.46666666865348816,0.46335697174072266,0.46666666865348816,0.46666666865348816,0,0,0.46335697399527187,0.4932723045349121
32,41,57,17,40,0,57,0.6774733662605286,0.46052631735801697,0.46335703134536743,0.46052631735801697,0.46052631735801697,0,0,0.46335697399527187,0.5311107635498047
33,41,40,0,40,0,40,0.6774301528930664,0.4791666865348816,0.46335697174072266,0.4791666865348816,0.4791666865348816,0,0,0.46335697399527187,0.784714937210083
34,38,52,18,34,0,52,0.6745418310165405,0.4759615361690521,0.46335697174072266,0.4759615361690521,0.4759615361690521,0,0,0.46335697399527187,0.3728652000427246
35,50,36,0,36,0,36,0.6809889674186707,0.4120370149612427,0.46335697174072266,0.4120370149612427,0.4120370149612427,0,0,0.46335697399527187,0.3647274971008301
36,53,33,0,33,0,33,0.6772642135620117,0.4621211886405945,0.46335697174072266,0.4621211886405945,0.4621211886405945,0,0,0.46335697399527187,0.38504695892333984
37,46,63,19,44,0,63,0.6738501787185669,0.4722221791744232,0.4633570611476898,0.4722221791744232,0.4722221791744232,0,0,0.46335697399527187,0.45273804664611816
38,53,41,0,41,0,41,0.6723756790161133,0.5,0.46335694193840027,0.5,0.5,0,0,0.46335697399527187,0.4062478542327881
39,51,67,30,37,0,67,0.6757623553276062,0.4527362883090973,0.46335697174072266,0.4527362883090973,0.4527362883090973,0,0,0.46335697399527187,0.5362026691436768
40,48,31,0,31,0,31,0.6715831756591797,0.5080645084381104,0.46335697174072266,0.5080645084381104,0.5080645084381104,0,0,0.46335697399527187,0.3366355895996094
41,53,37,3,34,0,37,0.6751680970191956,0.45495498180389404,0.46335694193840027,0.45495498180389404,0.45495498180389404,0,0,0.46335697399527187,0.2703843116760254
42,39,65,18,47,0,65,0.6744478344917297,0.4602563977241516,0.46335697174072266,0.4602563977241516,0.4602563977241516,0,0,0.46335697399527187,0.5369291305541992
43,44,54,13,41,0,54,0.6751924157142639,0.44598767161369324,0.46335697174072266,0.44598767161369324,0.44598767161369324,0,0,0.46335697399527187,0.6898419857025146
44,45,40,0,40,0,40,0.6744408011436462,0.4583333432674408,0.46335697174072266,0.4583333432674408,0.4583333432674408,0,0,0.46335697399527187,0.26294970512390137
45,47,31,0,31,0,31,0.6750675439834595,0.45967742800712585,0.46335697174072266,0.45967742800712585,0.45967742800712585,0,0,0.46335697399527187,0.2870802879333496
46,37,42,0,42,0,42,0.6732439994812012,0.4682539999485016,0.4633569121360779,0.4682539999485016,0.4682539999485016,0,0,0.46335697399527187,0.7073488235473633
47,55,57,13,44,0,57,0.6761888265609741,0.429824560880661,0.46339845657348633,0.429824560880661,0.429824560880661,0,0,0.46335697399527187,0.4287693500518799
48,58,42,2,40,0,42,0.6720206141471863,0.4742063283920288,0.463379442691803,0.4742063283920288,0.4742063283920288,0,0,0.46335697399527187,0.3930778503417969
49,42,41,0,41,0,41,0.6725356578826904,0.4674797058105469,0.46338000893592834,0.4674797058105469,0.4674797058105469,0,0,0.46335697399527187,0.4647030830383301
50,48,37,0,37,0,37,0.6716458201408386,0.4932432472705841,0.4633697271347046,0.4932432472705841,0.4932432472705841,0,0,0.46335697399527187,0.35929012298583984
51,44,49,17,32,0,49,0.6723123788833618,0.46088436245918274,0.4634341895580292,0.46088436245918274,0.46088436245918274,0,0,0.46335697399527187,0.3967702388763428
52,44,57,9,48,0,57,0.6697198748588562,0.48830410838127136,0.46343156695365906,0.48830410838127136,0.48830410838127136,0,0,0.46335697399527187,0.5913689136505127
53,43,42,0,42,0,42,0.6739385724067688,0.4583333432674408,0.4634357690811157,0.4583333432674408,0.4583333432674408,0,0,0.46335697399527187,0.3895533084869385
54,52,58,17,41,0,58,0.6706817150115967,0.47270113229751587,0.46351179480552673,0.47270113229751587,0.47270113229751587,0,0,0.46335697399527187,0.3980553150177002
55,47,54,16,38,0,54,0.6712242960929871,0.4660494029521942,0.46358466148376465,0.4660494029521942,0.4660494029521942,0,0,0.46382978723404256,0.3767085075378418
56,48,38,0,38,0,38,0.6702679991722107,0.48245614767074585,0.46343159675598145,0.48245614767074585,0.48245614767074585,0,0,0.46335697399527187,0.46387743949890137
57,44,62,18,44,0,62,0.6696292161941528,0.4744623899459839,0.46357810497283936,0.4744623899459839,0.4744623899459839,0,0,0.46382978723404256,0.5571019649505615
58,37,33,0,33,0,33,0.6740069389343262,0.42171716690063477,0.46354323625564575,0.42171716690063477,0.42171716690063477,0,0,0.46382978723404256,0.33881473541259766
59,49,65,23,42,0,65,0.6689205765724182,0.4794871509075165,0.4637061059474945,0.4794871509075165,0.4794871509075165,0,0,0.46382978723404256,0.7363190650939941
60,56,36,8,28,0,36,0.6666242480278015,0.49768516421318054,0.46369844675064087,0.49768516421318054,0.49768516421318054,0,0,0.46382978723404256,0.3560829162597656
61,42,45,2,43,0,45,0.6696692705154419,0.47037041187286377,0.46364063024520874,0.47037041187286377,0.47037041187286377,0,0,0.46382978723404256,0.4727020263671875
62,43,35,0,35,0,35,0.6708827018737793,0.45714282989501953,0.4636811912059784,0.45714282989501953,0.45714282989501953,0,0,0.46382978723404256,0.38265514373779297
63,48,41,4,37,0,41,0.6672230362892151,0.4918699562549591,0.4639335870742798,0.4918699562549591,0.4918699562549591,0,0,0.46382978723404256,0.36901092529296875
64,45,55,24,31,0,55,0.6675547361373901,0.4727272689342499,0.464534729719162,0.4727272689342499,0.4727272689342499,0,0,0.46430260047281324,0.35098838806152344
65,48,68,17,51,0,68,0.6666582822799683,0.48651957511901855,0.4645111858844757,0.48651957511901855,0.48651957511901855,0,0,0.46430260047281324,0.6961643695831299
66,56,63,28,35,0,63,0.6675577163696289,0.476190447807312,0.4652857482433319,0.476190447807312,0.476190447807312,0,0,0.4657210401891253,0.5118699073791504
67,47,55,19,36,0,55,0.6673610210418701,0.4742424488067627,0.46549755334854126,0.4742424488067627,0.4742424488067627,0,0,0.4657210401891253,0.6024863719940186
68,53,51,16,35,0,51,0.6677924990653992,0.4575164020061493,0.46640709042549133,0.4575164020061493,0.4575164020061493,0,0,0.4666666666666667,0.5353724956512451
69,45,38,14,24,0,38,0.6701067090034485,0.4451754093170166,0.467338502407074,0.4451754093170166,0.4451754093170166,0,0,0.46713947990543736,0.45567965507507324
70,54,43,0,43,0,43,0.6676042675971985,0.4748062193393707,0.4641816318035126,0.4748062193393707,0.4748062193393707,0,0,0.46382978723404256,0.35167527198791504
71,50,58,17,41,0,58,0.6679255962371826,0.4612068831920624,0.46559056639671326,0.4612068831920624,0.4612068831920624,0,0,0.4652482269503546,0.38988494873046875
72,53,59,28,31,0,59,0.6656079888343811,0.4661017060279846,0.4682213366031647,0.4661017060279846,0.4661017060279846,0,0,0.46761229314420805,0.26907920837402344
73,47,65,26,39,0,65,0.6649197936058044,0.4833333194255829,0.46920526027679443,0.4833333194255829,0.4833333194255829,0,0,0.4695035460992908,0.5562448501586914
74,50,41,0,41,0,41,0.6671169400215149,0.48577234148979187,0.46507522463798523,0.48577234148979187,0.48577234148979187,0,0,0.4657210401891253,0.45700550079345703
75,38,30,0,30,0,30,0.667639970779419,0.48055553436279297,0.46534278988838196,0.48055553436279297,0.48055553436279297,0,0,0.466193853427896,0.24776697158813477
76,45,38,0,38,0,38,0.6696114540100098,0.44956135749816895,0.4670275151729584,0.44956135749816895,0.44956135749816895,0,0,0.4666666666666667,0.3308882713317871
77,39,39,0,39,0,39,0.6685888171195984,0.4594016969203949,0.4665212035179138,0.4594016969203949,0.4594016969203949,0,0,0.466193853427896,0.30618810653686523
78,48,26,0,26,0,26,0.662943422794342,0.49679481983184814,0.46743044257164,0.49679481983184814,0.49679481983184814,0,0,0.46713947990543736,0.29685068130493164
79,48,49,0,49,0,49,0.6645886898040771,0.48129257559776306,0.4668596684932709,0.48129257559776306,0.48129257559776306,0,0,0.46713947990543736,0.40066075325012207
80,48,48,17,31,0,48,0.6605167984962463,0.5121527910232544,0.46907997131347656,0.5121527910232544,0.5121527910232544,0,0,0.4695035460992908,0.30328893661499023
81,46,32,0,32,0,32,0.6667163968086243,0.4765625298023224,0.4673463702201843,0.4765625298023224,0.4765625298023224,0,0,0.4690307328605201,0.3536694049835205
82,37,49,13,36,0,49,0.6657004952430725,0.4591837227344513,0.47122111916542053,0.4591837227344513,0.4591837227344513,0,0,0.47139479905437354,0.29093170166015625
83,41,23,0,23,0,23,0.6665369272232056,0.47101446986198425,0.4685373604297638,0.47101446986198425,0.47101446986198425,0,0,0.4699763593380615,0.2671048641204834
84,46,36,0,36,0,36,0.6628645062446594,0.4907407760620117,0.4683740437030792,0.4907407760620117,0.4907407760620117,0,0,0.4699763593380615,0.25646066665649414
85,42,47,7,40,0,47,0.6613242626190186,0.4858156144618988,0.47165635228157043,0.4858156144618988,0.4858156144618988,0,0,0.47092198581560285,0.29476332664489746
86,37,23,0,23,0,23,0.6677040457725525,0.4275362193584442,0.4741083085536957,0.4275362193584442,0.4275362193584442,0,0,0.47375886524822697,0.18013858795166016
87,48,52,11,41,0,52,0.6634562611579895,0.4839743375778198,0.4764866828918457,0.4839743375778198,0.4839743375778198,0,0,0.47848699763593383,0.3696732521057129
88,42,53,0,53,0,53,0.6636507511138916,0.46855342388153076,0.4737499952316284,0.46855342388153076,0.46855342388153076,0,0,0.4728132387706856,0.4206352233886719
89,49,44,0,44,0,44,0.6631119847297668,0.4829545319080353,0.4730066955089569,0.4829545319080353,0.4829545319080353,0,0,0.4765957446808511,0.4144253730773926
90,41,36,0,36,0,36,0.6582805514335632,0.5324074625968933,0.47428423166275024,0.5324074625968933,0.5324074625968933,0,0,0.47801418439716314,0.35202884674072266
91,34,30,0,30,0,30,0.6597195267677307,0.4972222149372101,0.4783136248588562,0.4972222149372101,0.4972222149372101,0,0,0.4817966903073286,0.20534467697143555
92,33,55,9,46,0,55,0.6615666747093201,0.47727271914482117,0.4793466627597809,0.47727271914482117,0.47727271914482117,0,0,0.48699763593380613,0.534477710723877
93,48,62,21,41,0,62,0.6627617478370667,0.4811827838420868,0.48623502254486084,0.4811827838420868,0.4811827838420868,0,0,0.49361702127659574,0.4608497619628906
94,45,46,7,39,0,46,0.6660054326057434,0.4583333432674408,0.4850652515888214,0.4583333432674408,0.4583333432674408,0,0,0.49314420803782505,0.4448528289794922
95,49,40,4,36,0,40,0.6612507104873657,0.49791669845581055,0.482990562915802,0.49791669845581055,0.49791669845581055,0,0,0.4907801418439716,0.4804966449737549
96,37,41,0,41,0,41,0.6626851558685303,0.48373979330062866,0.48440292477607727,0.48373979330062866,0.48373979330062866,0,0,0.4955082742316785,0.35550665855407715
97,41,35,0,35,0,35,0.6650228500366211,0.4595238268375397,0.47844651341438293,0.4595238268375397,0.4595238268375397,0,0,0.49030732860520093,0.4396097660064697
98,43,37,0,37,0,37,0.662818968296051,0.47522518038749695,0.48068493604660034,0.47522518038749695,0.47522518038749695,0,0,0.4884160756501182,0.3683629035949707
99,48,55,17,38,0,55,0.6579573154449463,0.5303030610084534,0.49366000294685364,0.5303030610084534,0.5303030610084534,0,0,0.49929078014184397,0.3414735794067383
